{
  "rooms":
  {
    "tut_1_endpoint":
    {
      "itemsGiven":
        [
          [0,0,0,0,0,0,0]],
      "itemsNeeded":
        [
          [0,0,0,0,0,0,0]],
      "layout":
        [
          [0,0,0,0,0,0,0,0,0,0,0,0,0,0,0,0,0,0,0,0,0,0,0,0],
          [0,0,0,0,0,0,0,0,0,0,0,0,0,0,0,0,0,0,0,0,0,0,0,0],
          [0,0,0,0,0,0,0,0,0,0,0,0,0,0,0,0,0,0,0,0,0,0,0,0],
          [0,0,0,0,0,0,0,0,0,0,0,0,0,0,0,0,0,0,0,0,0,0,0,0],
          [0,0,0,0,0,0,0,0,0,0,0,0,0,0,0,0,0,0,0,0,0,0,0,0],
          [0,0,0,0,0,0,0,0,0,0,0,19,0,0,0,0,0,0,0,0,0,0,0,0],
          [0,0,0,0,0,0,0,0,0,0,0,0,0,0,0,0,0,0,0,0,0,0,0,0],
          [0,0,0,0,0,0,0,0,0,0,0,0,0,0,0,0,0,0,0,0,0,0,0,0],
          [0,0,0,0,0,0,0,0,0,0,0,0,0,0,0,0,0,0,0,0,0,0,0,0],
          [0,0,0,0,0,0,0,0,0,0,0,0,0,0,0,0,0,0,0,0,0,0,0,0],
          [0,0,0,0,0,0,0,0,0,0,0,0,0,0,0,0,0,0,0,0,0,0,0,0],
          [0,0,0,0,0,0,0,0,0,0,0,0,0,0,0,0,0,0,0,0,0,0,0,0]],
      "isInitial": true
    },
    "tut_2_trapdoors":
    {
      "itemsGiven":
        [
          [1,0,0,0,0,0,0]],
      "itemsNeeded":
        [
          [0,0,0,0,0,0,0]],
      "layout":
        [
          [0,0,0,0,0,0,0,0,0,0,0,0,0,0,0,0,0,0,0,0,0,0,0,0],
          [0,0,0,0,0,0,0,0,0,0,0,0,0,0,0,0,0,0,0,0,0,0,0,0],
          [0,0,0,0,0,0,0,0,0,0,0,0,0,0,0,0,0,0,0,0,0,0,0,0],
          [0,0,0,0,0,0,0,0,0,13,13,13,13,13,0,0,0,0,0,0,0,0,0,0],
          [0,0,0,0,0,0,0,0,0,13,0,0,0,13,0,0,0,0,0,0,0,0,0,0],
          [0,0,0,0,0,0,0,0,0,13,0,19,0,13,0,0,0,0,0,0,0,0,0,0],
          [0,0,0,0,0,0,0,0,0,13,0,0,0,13,0,0,0,0,0,0,0,0,0,0],
          [0,0,0,0,0,0,0,0,0,13,12,13,12,13,0,0,0,0,0,0,0,0,0,0],
          [0,0,0,0,0,0,0,0,0,0,5.1,0,0,0,0,0,0,0,0,0,0,0,0,0],
          [0,0,0,0,0,0,0,0,0,0,3,0,0,0,0,0,0,0,0,0,0,0,0,0],
          [0,0,0,0,0,0,0,0,0,0,0,0,0,0,0,0,0,0,0,0,0,0,0,0],
          [0,0,0,0,0,0,0,0,0,0,0,0,0,0,0,0,0,0,0,0,0,0,0,0]]
    },
    "tut_3_walls":
    {
      "itemsGiven":
        [
          [0,0,0,0,0,0,0]],
      "itemsNeeded":
        [
          [1,0,0,0,0,0,0]],
      "layout":
        [
          [0,0,0,0,0,0,0,0,0,0,0,0,0,0,0,0,0,0,0,0,0,0,0,0],
          [0,0,0,0,0,0,0,0,0,0,0,0,0,0,0,0,0,0,0,0,0,0,0,0],
          [0,0,0,0,0,0,0.1,13,13,13,13,13,13,13,13,13,0,0,0,0,0,0,0,0],
          [0,0,0,0,0,0,0,13,0,0,0,0,0,0,0,13,0,0,0,0,0,0,0,0],
          [0,0,0,0,0,0,0,13,0,0,0,0,0,0,0,13,0,0,0,0,0,0,0,0],
          [0,0,0,0,0,0,0,13,0,0,0,19,0,0,0,13,0,0,0,0,0,0,0,0],
          [0,0,0,0,0,0,0,13,0,0,0,0,0,0,0.1,13,0,0,0,0,0,0,0,0],
          [0,0,0,0,0,0,0,13,0,0,0,0,0,0,0,13,0,0,0,0,0,0,0,0],
          [0,0,0,0,0,0,0,13,13,13,13,13,13,13,13,13,0,0,0,0,0,0,0,0],
          [0,0,0,0,0,0,0,0,0,0,0,0,0,0,0,0,0,0,0,0,0,0,0,0],
          [0,0,0,0,0,0,0,0,0,0,0,0,0,0,0,0,0,0,0,0,0,0,0,0],
          [0,0,0,0,0,0,0,0,0,0,0,0,0,0,0,0,0,0,0,0,0,0,0,0]]
    },
    "tut_4_buttons":
    {
      "itemsGiven":
        [
          [0,1,0,0,0,0,0]],
      "itemsNeeded":
        [
          [0,0,0,0,0,0,0]],
      "layout":
        [
          [0,0,0,0,0,0,0,0,0,0,0,0,0,0,0,0,0,0,0,0,0,0,0,0],
          [0,0,0,0,0,0,0,0,0,0,0,0,0,0,0,0,0,0,0,0,0,0,0,0],
          [0,0,0,0,0,0,0,0,0,0,0,0,0,0,0,0,0,0,0,0,0,0,0,0],
          [0,0,0,0,0,0,0,0,0,0,0,0,0,0,0,0,0,0,0,0,0,0,0,0],
          [0,0,0,0,0,0,0,13,13,13,13,13,13,13,13,0,0,0,0,0,0,0,0,0],
          [0,0,0,0,0,0,0,13,19,0,12,0,0,0,12,5,8,5,3,0,0,0,0,0],
          [0,0,0,0,0,0,0,13,13,13,20,13,13,13,13,0,0,0,0,0,0,0,0,0],
          [0,0,0,0,0,0,0,0,0,0,5.1,0,0,0,0,0,0,0,0,0,0,0,0,0],
          [0,0,0,0,0,0,0,0,0,0,8,0,0,0,0,0,0,0,0,0,0,0,0,0],
          [0,0,0,0,0,0,0,0,0,0,3,0,0,0,0,0,0,0,0,0,0,0,0,0],
          [0,0,0,0,0,0,0,0,0,0,0,0,0,0,0,0,0,0,0,0,0,0,0,0],
          [0,0,0,0,0,0,0,0,0,0,0,0,0,0,0,0,0,0,0,0,0,0,0,0]]
    },
    "tut_5_ladder":
    {
      "itemsGiven":
        [
          [0,0,0,0,0,0,0]],
      "itemsNeeded":
        [
          [0,1,0,0,0,0,0]],
      "layout":
        [
          [0,0,0,0,0,0,0,0,0,0,0,0,0,0,0,0,0,0,0,0,0,0,0,0],
          [0,0,0,0,0,0,0,0,0,0,0,0,0,0,0,0,0,0,0,0,0,0,0,0],
          [0,0,0,0,0,0,0,0,0,0,0,0,0,0,0,0,0,0,0,0,0,0,0,0],
          [0,0,0,0,0,0,0,0,0,31,31,31,31,31,0,0,0,0,0,0,0,0,0,0],
          [0,0,0,0,0,0,0,0,0,31,0,0,0,31,0,0,0,0,0,0,0,0,0,0],
          [0,0,0,0,0,0,0,0,0,12,0,19,0,31,0,0,0,0,0,0,0,0,0,0],
          [0,0,0,0,0,0,0,0,0,31,0,0,0,31,0,0,0,0,0,0,0,0,0,0],
          [0,0,0,0,0,0,0,0,0,31,31,31,31,31,0,0,0,0,0,0,0,0,0,0],
          [0,0,0,0,0,0,0,0,0,0,0,0,0,0,0,0,0,0,0,0,0,0,0,0],
          [0,0,0,0,0,0,0,0,0,0,0,0,0,0,0,0,0,0,0,0,0,0,0,0],
          [0,0,0,0,0,0,0,0,0,0,0,0,0,0,0,0,0,0,0,0,0,0,0,0],
          [0,0,0,0,0,0,0,0,0,0,0,0,0,0,0,0,0,0,0,0,0,0,0,0]]
    },
    "tut_6_pitbull":
    {
      "itemsGiven":
        [
          [1,0,0,0,0,0,0]],
      "itemsNeeded":
        [
          [0,0,0,0,0,0,0]],
      "layout":
        [
          [0,0,0,0,0,0,0,0,0,0,0,0,0,0,0,0,0,0,0,0,0,0,0,0],
          [0,0,0,0,0,0,0,0,0,0,0,0,0,0,0,0,0,0,0,0,0,0,0,0],
          [0,0,0,0,0,0,0,0,0,0,0,0,0,0,0,0,0,0,0,0,0,0,0,0],
          [0,0,0,0,0,0,0,0,0,0,0,0,0,0,0,0,0,0,0,0,0,0,0,0],
          [0,0,13,13,13,13,13,13,13,13,13,13,13,13,13,13,13,13,13,13,0,0,0,0],
          [0,0,0,0,0,0,0,0,0,0,0,19,0,0,12,8,3,0,21.1,13,0,0,0,0],
          [0,0,13,13,13,13,13,13,13,13,13,13,13,13,13,13,13,13,13,13,0,0,0,0],
          [0,0,0,0,0,0,0,0,0,0,0,0,0,0,0,0,0,0,0,0,0,0,0,0],
          [0,0,0,0,0,0,0,0,0,0,0,0,0,0,0,0,0,0,0,0,0,0,0,0],
          [0,0,0,0,0,0,0,0,0,0,0,0,0,0,0,0,0,0,0,0,0,0,0,0],
          [0,0,0,0,0,0,0,0,0,0,0,0,0,0,0,0,0,0,0,0,0,0,0,0],
          [0,0,0,0,0,0,0,0,0,0,0,0,0,0,0,0,0,0,0,0,0,0,0,0]]
    },
    "tut_7_stack":
    {
      "itemsGiven":
        [
          [0,1,0,0,0,0,0]],
      "itemsNeeded":
        [
          [1,0,0,0,0,0,0]],
      "layout":
        [
          [0,0,0,0,0,0,0,0,0,0,0,0,0,0,0,0,31,0,0,0,0,0,0,0],
          [0,0,0,0,0,0,0,0,0,0,0,0,0,0,0,0,31,0,0,0,0,0,0,0],
          [0,0,13,13,13,13,13,13,0,31,31,31,31,0,31,31,31,0,0,13,13,13,0,0],
          [0,0,0,0,0,0,0,13,0,31,0,0,31,0,31,0,13,0,0,13,13,13,0,0],
          [0,0,0,0.1,0,0,0,13,0,31,0,0,31,0,31,0,13,0,0,0,0,0,0,0],
          [0,0,0,0,0,0,0,13,0,31,0,0,31,21.2,31,0,13,0,0,0,0,0,0,0],
          [0,0,0,0,0,0,0,31,12,20,5,5,20,8,20,3,13,0,0,0,0,0,0,0],
          [0,0,0,0,0,0,0,31,0,31,0,0,31,31,31,0,13,0,0,0,0,0,0,0],
          [0,0,0,0,0,0,0,31,19,31,0,0,0,0,0,0,13,0,0,0,0,0,0,0],
          [0,0,0,0,0,0,0,31,31,31,0,13,13,13,13,13,13,0,0,0,0,0,0,0],
          [0,0,0,0,0,0,0,0,0,0,0,0,0,0,0,0,0,0,0,0,0,0,0,0],
          [0,0,0,0,0,0,0,0,0,0,0,0,0,0,0,0,0,0,0,0,0,0,0,0]]
    },
    "tut_8_srdt1":
    {
      "itemsGiven":
        [
          [1,0,0,0,0,0,0]],
      "itemsNeeded":
        [
          [0,1,0,0,0,0,0]],
      "layout":
        [
          [0,0,0,0,0,0,0,0,0,0,0,0,0,0,0,0,0,0,0,0,0,0,0,0],
          [0,0,0,0,0,0,0,0,0,0,0,0,0,0,0,0,0,8,3,0,0,0,0,0],
          [0,0,13,13,13,13,13,13,13,13,13,13,20,25,13,13,13,20,13,20,20,20,13,0],
          [0,0,13,13,13,13,13,13,13,13,13,13,20,4,13,13,13,20,13,16,13,20,13,0],
          [0,0,13,13,13,13,13,13,13,13,13,13,13,16,13,13,13,20,20,20,13,20,13,0],
          [0,0,25,9,3,8,12,0,12,0,11,0,0,8,0,0,12,0,0,0,19,20,13,0],
          [0,0,20,20,13,20,13,20,20,20,5.1,13,13,3,13,13,5.1,13,13,13,13,20,13,0],
          [0,0,13,13,13,20,13,16,24,20,15,20,20,5,20,20,15,20,20,20,20,20,13,0],
          [0,0,13,13,13,20,20,20,24,13,13,20,13,13,13,13,13,13,13,13,13,13,13,0],
          [0,0,0,0,0,0,0,0,0,0,0,5.1,0,0,0,0,0,0,0,0,0,0,0,0],
          [0,0,0,0,0,0,0,0,0,0,0,8,3,0,0,0,0,0,0,0,0,0,0,0],
          [0,0,0,0,0,0,0,0,0,0,0,0,0,0,0,0,0,0,0,0,0,0,0,0]]
    },
    "tut_9_srdt2":
    {
      "itemsGiven":
        [
          [0,0,0,0,0,0,0]],
      "itemsNeeded":
        [
          [1,0,0,0,0,0,0]],
      "layout":
        [
          [0,0,0,0,0,0,0,0,0,0,0,0,0,0,0,0,0,0,0,0,0,0,0,0],
          [0,0,0,0,0,0,0,0,0,0,0,0,0,0,0,0,0,8,3,0,0,0,0,0],
          [0,0,13,13,13,13,13,13,13,13,13,13,20,25,13,13,13,20,13,20,20,20,13,0],
          [0,0,13,13,13,13,13,13,13,13,13,13,20,4,13,13,13,20,13,16,13,20,13,0],
          [0,0,13,13,13,13,13,13,13,13,13,13,13,16,13,13,13,20,20,20,13,20,13,0],
          [0,0,25,9,3,8,12,0,12,0,11,0,0,8,0,0,12,0,0,0,19,20,13,0],
          [0,0,20,20,13,20,13,20,20,20,5.1,13,13,3,13,13,5.1,13,13,13,13,20,13,0],
          [0,0,13,13,13,20,13,16,24,20,15,20,20,5,20,20,15,20,20,20,20,20,13,0],
          [0,0,13,13,13,20,20,20,24,13,13,20,13,13,13,13,13,13,13,13,13,13,13,0],
          [0,0,0,0,0,0,0,0,0,0,0,5.1,0,0,0,0,0,0,0,0,0,0,0,0],
          [0,0,0,0,0,0,0,0,0,0,0,8,3,0,0,0,0,0,0,0,0,0,0,0],
          [0,0,0,0,0,0,0,0,0,0,0,0,0,0,0,0,0,0,0,0,0,0,0,0]]
    }
  }
}