{
  "rooms":
  {
    "tut_1_endpoint":
    {
      "itemsGiven":
        [
          [0,0,0,0,0,0,0]],
      "itemsNeeded":
        [
          [0,0,0,0,0,0,0]],
      "layout":
        [
          [0,0,0,0,0,0,0,0,0,0,0,0,0,0,0,0,0,0,0,0,0,0,0,0],
          [0,0,0,0,0,0,0,0,0,0,0,0,0,0,0,0,0,0,0,0,0,0,0,0],
          [0,0,0,0,0,0,0,0,0,0,0,0,0,0,0,0,0,0,0,0,0,0,0,0],
          [0,0,0,0,0,0,0,0,0,0,0,0,0,0,0,0,0,0,0,0,0,0,0,0],
          [0,0,0,0,0,0,0,0,0,0,0,0,0,0,0,0,0,0,0,0,0,0,0,0],
          [0,0,0,0,0,0,0,0,0,0,0,19,0,0,0,0,0,0,0,0,0,0,0,0],
          [0,0,0,0,0,0,0,0,0,0,0,0,0,0,0,0,0,0,0,0,0,0,0,0],
          [0,0,0,0,0,0,0,0,0,0,0,0,0,0,0,0,0,0,0,0,0,0,0,0],
          [0,0,0,0,0,0,0,0,0,0,0,0,0,0,0,0,0,0,0,0,0,0,0,0],
          [0,0,0,0,0,0,0,0,0,0,0,0,0,0,0,0,0,0,0,0,0,0,0,0],
          [0,0,0,0,0,0,0,0,0,0,0,0,0,0,0,0,0,0,0,0,0,0,0,0],
          [0,0,0,0,0,0,0,0,0,0,0,0,0,0,0,0,0,0,0,0,0,0,0,0]],
      "isInitial": true
    },
    "tut_2_trapdoors":
    {
      "itemsGiven":
        [
          [1,0,0,0,0,0,0]],
      "itemsNeeded":
        [
          [0,0,0,0,0,0,0]],
      "layout":
        [
          [0,0,0,0,0,0,0,0,0,0,0,0,0,0,0,0,0,0,0,0,0,0,0,0],
          [0,0,0,0,0,0,0,0,0,0,0,0,0,0,0,0,0,0,0,0,0,0,0,0],
          [0,0,0,0,0,0,0,0,0,0,0,0,0,0,0,0,0,0,0,0,0,0,0,0],
          [0,0,0,0,0,0,0,0,0,13,13,13,13,13,0,0,0,0,0,0,0,0,0,0],
          [0,0,0,0,0,0,0,0,0,13,0,0,0,13,0,0,0,0,0,0,0,0,0,0],
          [0,0,0,0,0,0,0,0,0,13,0,19,0,13,0,0,0,0,0,0,0,0,0,0],
          [0,0,0,0,0,0,0,0,0,13,0,0,0,13,0,0,0,0,0,0,0,0,0,0],
          [0,0,0,0,0,0,0,0,0,13,12,13,12,13,0,0,0,0,0,0,0,0,0,0],
          [0,0,0,0,0,0,0,0,0,0,5.1,0,0,0,0,0,0,0,0,0,0,0,0,0],
          [0,0,0,0,0,0,0,0,0,0,3,0,0,0,0,0,0,0,0,0,0,0,0,0],
          [0,0,0,0,0,0,0,0,0,0,0,0,0,0,0,0,0,0,0,0,0,0,0,0],
          [0,0,0,0,0,0,0,0,0,0,0,0,0,0,0,0,0,0,0,0,0,0,0,0]]
    },
    "tut_3_walls":
    {
      "itemsGiven":
        [
          [0,0,0,0,0,0,0]],
      "itemsNeeded":
        [
          [1,0,0,0,0,0,0]],
      "layout":
        [
          [0,0,0,0,0,0,0,0,0,0,0,0,0,0,0,0,0,0,0,0,0,0,0,0],
          [0,0,0,0,0,0,0,0,0,0,0,0,0,0,0,0,0,0,0,0,0,0,0,0],
          [0,0,0,0,0,0,0.1,13,13,13,13,13,13,13,13,13,0,0,0,0,0,0,0,0],
          [0,0,0,0,0,0,0,13,0,0,0,0,0,0,0,13,0,0,0,0,0,0,0,0],
          [0,0,0,0,0,0,0,13,0,0,0,0,0,0,0,13,0,0,0,0,0,0,0,0],
          [0,0,0,0,0,0,0,13,0,0,0,19,0,0,0,13,0,0,0,0,0,0,0,0],
          [0,0,0,0,0,0,0,13,0,0,0,0,0,0,0.1,13,0,0,0,0,0,0,0,0],
          [0,0,0,0,0,0,0,13,0,0,0,0,0,0,0,13,0,0,0,0,0,0,0,0],
          [0,0,0,0,0,0,0,13,13,13,13,13,13,13,13,13,0,0,0,0,0,0,0,0],
          [0,0,0,0,0,0,0,0,0,0,0,0,0,0,0,0,0,0,0,0,0,0,0,0],
          [0,0,0,0,0,0,0,0,0,0,0,0,0,0,0,0,0,0,0,0,0,0,0,0],
          [0,0,0,0,0,0,0,0,0,0,0,0,0,0,0,0,0,0,0,0,0,0,0,0]]
    },
    "tut_4_buttons":
    {
      "itemsGiven":
        [
          [0,1,0,0,0,0,0]],
      "itemsNeeded":
        [
          [0,0,0,0,0,0,0]],
      "layout":
        [
          [0,0,0,0,0,0,0,0,0,0,0,0,0,0,0,0,0,0,0,0,0,0,0,0],
          [0,0,0,0,0,0,0,0,0,0,0,0,0,0,0,0,0,0,0,0,0,0,0,0],
          [0,0,0,0,0,0,0,0,0,0,0,0,0,0,0,0,0,0,0,0,0,0,0,0],
          [0,0,0,0,0,0,0,0,0,0,0,0,0,0,0,0,0,0,0,0,0,0,0,0],
          [0,0,0,0,0,0,0,13,13,13,13,13,13,13,13,0,0,0,0,0,0,0,0,0],
          [0,0,0,0,0,0,0,13,19,0,12,0,0,0,12,5,8,5,3,0,0,0,0,0],
          [0,0,0,0,0,0,0,13,13,13,20,13,13,13,13,0,0,0,0,0,0,0,0,0],
          [0,0,0,0,0,0,0,0,0,0,5.1,0,0,0,0,0,0,0,0,0,0,0,0,0],
          [0,0,0,0,0,0,0,0,0,0,8,0,0,0,0,0,0,0,0,0,0,0,0,0],
          [0,0,0,0,0,0,0,0,0,0,3,0,0,0,0,0,0,0,0,0,0,0,0,0],
          [0,0,0,0,0,0,0,0,0,0,0,0,0,0,0,0,0,0,0,0,0,0,0,0],
          [0,0,0,0,0,0,0,0,0,0,0,0,0,0,0,0,0,0,0,0,0,0,0,0]]
    },
    "tut_5_ladder":
    {
      "itemsGiven":
        [
          [0,0,0,0,0,0,0]],
      "itemsNeeded":
        [
          [0,1,0,0,0,0,0]],
      "layout":
        [
          [0,0,0,0,0,0,0,0,0,0,0,0,0,0,0,0,0,0,0,0,0,0,0,0],
          [0,0,0,0,0,0,0,0,0,0,0,0,0,0,0,0,0,0,0,0,0,0,0,0],
          [0,0,0,0,0,0,0,0,0,0,0,0,0,0,0,0,0,0,0,0,0,0,0,0],
          [0,0,0,0,0,0,0,0,0,31,31,31,31,31,0,0,0,0,0,0,0,0,0,0],
          [0,0,0,0,0,0,0,0,0,31,0,0,0,31,0,0,0,0,0,0,0,0,0,0],
          [0,0,0,0,0,0,0,0,0,12,0,19,0,31,0,0,0,0,0,0,0,0,0,0],
          [0,0,0,0,0,0,0,0,0,31,0,0,0,31,0,0,0,0,0,0,0,0,0,0],
          [0,0,0,0,0,0,0,0,0,31,31,31,31,31,0,0,0,0,0,0,0,0,0,0],
          [0,0,0,0,0,0,0,0,0,0,0,0,0,0,0,0,0,0,0,0,0,0,0,0],
          [0,0,0,0,0,0,0,0,0,0,0,0,0,0,0,0,0,0,0,0,0,0,0,0],
          [0,0,0,0,0,0,0,0,0,0,0,0,0,0,0,0,0,0,0,0,0,0,0,0],
          [0,0,0,0,0,0,0,0,0,0,0,0,0,0,0,0,0,0,0,0,0,0,0,0]]
    },
    "tut_6_pitbull":
    {
      "itemsGiven":
        [
          [1,0,0,0,0,0,0]],
      "itemsNeeded":
        [
          [0,0,0,0,0,0,0]],
      "layout":
        [
          [0,0,0,0,0,0,0,0,0,0,0,0,0,0,0,0,0,0,0,0,0,0,0,0],
          [0,0,0,0,0,0,0,0,0,0,0,0,0,0,0,0,0,0,0,0,0,0,0,0],
          [0,0,0,0,0,0,0,0,0,0,0,0,0,0,0,0,0,0,0,0,0,0,0,0],
          [0,0,0,0,0,0,0,0,0,0,0,0,0,0,0,0,0,0,0,0,0,0,0,0],
          [0,0,13,13,13,13,13,13,13,13,13,13,13,13,13,13,13,13,13,13,0,0,0,0],
          [0,0,0,0,0,0,0,0,0,0,0,19,0,0,12,8,3,0,21.1,13,0,0,0,0],
          [0,0,13,13,13,13,13,13,13,13,13,13,13,13,13,13,13,13,13,13,0,0,0,0],
          [0,0,0,0,0,0,0,0,0,0,0,0,0,0,0,0,0,0,0,0,0,0,0,0],
          [0,0,0,0,0,0,0,0,0,0,0,0,0,0,0,0,0,0,0,0,0,0,0,0],
          [0,0,0,0,0,0,0,0,0,0,0,0,0,0,0,0,0,0,0,0,0,0,0,0],
          [0,0,0,0,0,0,0,0,0,0,0,0,0,0,0,0,0,0,0,0,0,0,0,0],
          [0,0,0,0,0,0,0,0,0,0,0,0,0,0,0,0,0,0,0,0,0,0,0,0]]
    },
    "tut_7_stack":
    {
      "itemsGiven":
        [
          [0,1,0,0,0,0,0]],
      "itemsNeeded":
        [
          [1,0,0,0,0,0,0]],
      "layout":
      [
        [0,0,0,0,0,0,0,0,0,0,0,0,0,0,0,0,0,0,0,0,0,0,0,0]
[0,0,0,0,0,0,0,0,0,0,0,0,0,0,0,0,0,0,0,0,0,0,0,0]
[0,0,0,0,0,0,0,0,0,0,0,0,0,0,0,0,0,0,0,0,0,0,0,0]
[0,0,0,0,0,31,31,31,31,31,0,0,0,0,31,64,31,0,0,0,0,0,0,0]
[0,0,0,0,0,31,11,20,0,31,0,0,0,0,31,0,31,0,0,0,0,0,0,0]
[0,0,0,0,0,31,11,20,5,48.1,5,5,5,5,20,8,20,6.1,0,0,0,0,0,0]
[0,0,0,0,0,0,0,31,0,31,0,0,0,0,31,21,31,3,0,0,0,0,0,0]
[0,0,0,0,0,0,0,31,12,48.1,5,5,5,5,20,8,20,6.2,0,0,0,0,0,0]
[0,0,0,0,0,0,0,31,19,31,0,0,0,0,31,31,31,0,0,0,0,0,0,0]
[0,0,0,0,0,0,0,31,64,31,0,0,0,0,0,0,0,0,0,0,0,0,0,0]
[0,0,0,0,0,0,0,0,0,0,0,0,0,0,0,0,0,0,0,0,0,0,0,0]
[0,0,0,0,0,0,0,0,0,0,0,0,0,0,0,0,0,0,0,0,0,0,0,0]
      ],
    },
    "tut_8_srdt1":
    {
      "itemsGiven":
        [
          [1,0,0,0,0,0,0]],
      "itemsNeeded":
        [
          [0,1,0,0,0,0,0]],
      "layout":
      [
        [0,0,0,0,0,0,0,0,0,0,0,0,0,0,0,0,0,0,0,0,0,0,0,0]
[0,0,0,0,31,31,31,31,31,31,31,31,31,31,31,31,31,31,31,31,0,0,0,0]
[0,0,0,0,31,0,0,0,0,0,0,0,0,3,0,0,0,0,0,31,0,0,0,0]
[0,0,0,0,31,0,0,0,20,20,20,20,20,20,31,31,31,0,0,31,0,0,0,0]
[0,0,0,0,31,11,55.1,8,20,31,31,31,31,48,31,31,31,0,0,31,0,0,0,0]
[0,0,0,0,0,0,48,21,0,11,64,19,21,8,0,12,18.1,0,0,31,0,0,0,0]
[0,0,0,0,31,12,54.3,31,31,48,31,31,31,48,31,48.2,31,0,0,31,0,0,0,0]
[0,0,0,0,31,0,0,0,8,6.2,0,0,31,20,16.1,20,31,0,0,31,0,0,0,0]
[0,0,0,0,31,0,0,0,3,0,0,0,31,0,0,0,0,0,0,31,0,0,0,0]
[0,0,0,0,31,31,31,31,31,31,31,31,31,31,31,31,31,31,31,31,0,0,0,0]
[0,0,0,0,0,0,0,0,0,0,0,0,0,0,0,0,0,0,0,0,0,0,0,0]
[0,0,0,0,0,0,0,0,0,0,0,0,0,0,0,0,0,0,0,0,0,0,0,0]
      ],
    },
    "tut_9_srdt2":
    {
      "itemsGiven":
        [
          [0,0,0,0,0,0,0]],
      "itemsNeeded":
        [
          [1,0,0,0,0,0,0]],
      "layout":
      [
        [0,0,0,0,0,0,0,0,0,0,0,0,0,0,0,0,0,0,0,0,0,0,0,0]
[0,0,0,0,31,31,31,31,31,31,31,31,31,31,31,31,31,31,31,31,0,0,0,0]
[0,0,0,0,31,0,0,0,0,0,0,0,0,3,0,0,0,0,0,31,0,0,0,0]
[0,0,0,0,31,0,0,0,20,20,20,20,20,20,31,31,31,0,0,31,0,0,0,0]
[0,0,0,0,31,11,55.1,8,20,31,31,31,31,48,31,31,31,0,0,31,0,0,0,0]
[0,0,0,0,0,0,48,21,0,11,64,19,21,8,0,12,18.1,0,0,31,0,0,0,0]
[0,0,0,0,31,12,54.3,31,31,48,31,31,31,48,31,48.2,31,0,0,31,0,0,0,0]
[0,0,0,0,31,0,0,0,8,6.2,0,0,31,20,16.1,20,31,0,0,31,0,0,0,0]
[0,0,0,0,31,0,0,0,3,0,0,0,31,0,0,0,0,0,0,31,0,0,0,0]
[0,0,0,0,31,31,31,31,31,31,31,31,31,31,31,31,31,31,31,31,0,0,0,0]
[0,0,0,0,0,0,0,0,0,0,0,0,0,0,0,0,0,0,0,0,0,0,0,0]
[0,0,0,0,0,0,0,0,0,0,0,0,0,0,0,0,0,0,0,0,0,0,0,0]
      ],
    },
    "tut_and":
    {
      "itemsGiven":
      [
        [0,0,0,0,0,0,0]
      ],
      "itemsNeeded":
      [
        [0, 0, 1, 0, 0, 0, 0]
      ],
      "layout":
      [
        [0,0,0,0,0,0,0,0,0,0,0,0,0,0,33,33,33,33,33,33,33,0,0,0]
        [0,0,0,0,0,0,0,0,0,0,0,0,0,0,33,33,33,33,33,33,33,0,0,0]
        [0,0,3,8,5,5,5,6.1,0,0,0,0,0,0,33,33,33,33,33,33,33,0,0,0]
        [0,0,0,0,31,11,31,5.1,0,0,0,0,0,0,33,33,33,33,33,33,33,0,0,0]
        [0,0,0,0,31,12,31,5.1,0,0,0,0,0,0,33,33,33,33,33,33,33,0,0,0]
        [0,0,0,0,31,12,48.1,15.3,0,0,0,0,0,0,12,12,12,12,12,12,12,9,3,0]
        [0,0,0,0,31,19,31,5.1,0,0,0,0,0,0,12,12,12,12,12,12,12,9,3,0]
        [0,31,31,31,31,20,20,20,24,31,31,31,0,0,33,33,33,33,33,33,33,0,0,0]
        [0,31,21,0,3,10,0,0,0,0,0,31,0,0,33,33,33,33,33,33,33,0,0,0]
        [0,31,31,31,31,31,31,31,31,31,31,31,0,0,33,33,33,33,33,33,33,0,0,0]
        [0,0,0,0,0,0,0,0,0,0,0,0,0,0,33,33,33,33,33,33,33,0,0,0]
        [0,0,0,0,0,0,0,0,0,0,0,0,0,0,33,33,33,33,33,33,33,0,0,0]
      ],
    },
    "tut_or":
    {
      "itemsNeeded":
      [
        [0,0,0,0,0,0,0]
      ],
      "itemsGiven":
      [
        [0,0,0,0,0,0,0]
      ],
      "layout":
      [
        [0,0,0,0,0,0,0,0,0,0,0,0,0,0,0,0,0,0,0,0,0,0,0,0]
        [0,0,0,0,3,0,0,0,0,0,0,0,0,0,0,0,0,0,0,0,0,0,0,0]
        [0,0,0,0,8,55.1,7,54.2,0,0,0,0,0,0,0,0,24,0,24,0,0,0,0,0]
        [0,0,0,0,32,11,11,48,0,0,0,0,0,0,0,0,24,0,0,0,0,0,0,0]
        [0,0,0,0,32,32,0,48,31,0,0,0,0,0,0,24,24,0,0,0,0,0,0,0]
        [0,0,0,0,32,32,37,17.3,31,0,0,0,0,0,0,24,0,0,0,0,0,0,0,0]
        [0,0,0,0,32,32,0,48,31,0,0,0,0,0,0,24,24,0,0,0,0,0,0,0]
        [0,0,0,0,32,11,11,48,0,0,0,0,0,0,0,0,24,0,0,0,0,0,0,0]
        [0,0,0,0,8,55.3,7.2,54.3,0,0,0,0,0,0,0,0,24,0,24,0,0,0,0,0]
        [0,0,0,0,3,0,0,0,0,0,0,0,0,0,0,0,0,0,0,0,0,0,0,0]
        [0,0,0,0,0,0,0,0,0,0,0,0,0,0,0,0,0,0,0,0,0,0,0,0]
        [0,0,0,0,0,0,0,0,0,0,0,0,0,0,0,0,0,0,0,0,0,0,0,0]
      ],
    },
  }
}